7
20
####################
#..................#
#..................#
#.........###......#
###.......# #......#
  #.......# #......#
  ######### ########